5 10 4
##########
#        #
#        #
#    *   #
##########