6 14 5
##############
#       ##   #         
#..#   # # # #     
#  #     .  ##       
#  ##    . #*#    
..............